1111111111111111111111
10000000000C0000C00001
1001111111111111010001
110000C000010000010E01
1001111010010011111111
110000000011000001C001
1001000100011111110001
100100C001110000C00001
1001001100010001111111
1C01001100010001111111
1000001100010000000001
1C0100110001C001111111
1010001100010000000001
11P000000100011100C001
1111111111111111111111
