1111111111111111111111
10000000000C0000C00001
1001111111111111010001
110000C000010000010E01
1001111010010011111111
110000000011000001C001
1001000100011111110001
100100C000000000C000P1
1111111111111111111111
