11111111111111
100C0000C0P001
11111111101001
110000C0000101
10011110100101
11000000001101
10010001000111
1E0100C0000001
11111111111111
